11111111
1P0C0001
10E00001
1C001101
10011001
11111111