1111111
1P0C0E1
1000001
1C00111
1111111

