1111111111
1P001000E1
1001110101
1C01100111
1101101101
1C00000001
1111111111