11111111111111111111
11E0000000000000C001
11010010100100000101
11010010010101010001
11P0000000C00C000001
11111111111111111111
